// Usage Instructions: 
// Paste below query in log analytics, click on Save button and select as Function from drop down by specifying function name as ProofpointTAPEvent and specifying Legacy Category.
// This function maps Proofpoint Targeted Attack Protection events to Microsoft Sentinel Information Model (ASIM) (https://docs.microsoft.com/azure/sentinel/normalization).
// Function usually takes 10-15 minutes to activate. You can then use function alias from any other queries (e.g. ProofpointTAPEvent | take 10).
// Reference : Using functions in Azure monitor log queries : https://docs.microsoft.com/azure/azure-monitor/log-query/functions
union isfuzzy=true ProofpointTAPNativePoller_CL, ProofPointTAPMessagesDelivered_CL, ProofPointTAPMessagesBlocked_CL, ProofPointTAPClicksPermitted_CL, ProofPointTAPClicksBlocked_CL
| extend EventVendor = 'Proofpoint',
         EventProduct = 'Targeted Attack Protection',
         EventCount = '1'
| project-rename CcAddresses=ccAddresses_s,
	             Cluster=cluster_s,
	             CompletelyRewritten=completelyRewritten_b,
	             SrcUsername=fromAddress_s,
	             EventOriginalUid=GUID_s,
	             HeaderFrom=headerFrom_s,
	             HeaderReplyTo=headerReplyTo_s,
	             Id=id_g,
	             ImpostorScore=impostorScore_d,
	             MalwareScore=malwareScore_d,
	             MessageId=messageID_s,
	             MessageParts=messageParts_s,
	             NetworkBytes=messageSize_d,
	             EventEndTime=messageTime_t,
	             ModulesRun=modulesRun_s,
	             PhishScore=phishScore_d,
	             PolicyRoutes=policyRoutes_s,
	             Qid=QID_s,
	             QuarantineFolder=quarantineFolder_s,
	             QuarantineRule=quarantineRule_s,
	             Recipient=recipient_s,
	             ReplyToAddress=replyToAddress_s,
	             Sender=sender_s,
	             SrcIpAddr=senderIP_s,
	             SpamScore=spamScore_d,
	             Subject=subject_s,
	             ThreatsInfoMap=threatsInfoMap_s,
	             DstUsername=toAddresses_s,
	             Xmailer=xmailer_s