SalesforceServiceCloud_CL 
| extend 
		RequestSize=column_ifexists('request_size_s',''),
		ExecTime=column_ifexists('exec_time_s',''),
		Action=column_ifexists('action_s',''),
		PlatformType=column_ifexists('platform_type_s',''),
		OsName=column_ifexists('os_name_s',''),
		OsVersion=column_ifexists('os_version_s',''),
		Timestamp=column_ifexists('timestamp_s',''),
		StatusCode=column_ifexists('status_code_s',''),
		EventType=column_ifexists('event_type_s',''),
		ReferrerUri=column_ifexists('referrer_uri_s',''),
		UserAgent=column_ifexists('user_agent_s',''),
		BrowserType=column_ifexists('browser_type_s',''),
		Time=column_ifexists('time_s',''),
		ResponseSize=column_ifexists('response_size_s',''),
		DeviceId=column_ifexists('device_id_s',''),
		DeviceModel=column_ifexists('device_model_s',''),
		SourceIp=column_ifexists('source_ip_s',''),
		ClientIp=column_ifexists('client_ip_s',''),
		Success=column_ifexists('success_s',''),
		Uri=column_ifexists('uri_s',''),
		Url=column_ifexists('url_s',''),
		ClientName=column_ifexists('client_name_s',''),
		UserType=column_ifexists('user_type_s',''),
		UserInitiatedLogout=column_ifexists('user_initiated_logout_s',''),
		UserIdDerived=column_ifexists('user_id_derived_s',''),
		UserId=column_ifexists('user_id_s',''),
		UserEmail=column_ifexists('user_email_s',''),
		User=column_ifexists('user_name_s',''),
		UriIdDerived=column_ifexists('uri_id_derived_s',''),
		UiEventType=column_ifexists('ui_event_type_s',''),
		UiEventTimestamp=column_ifexists('ui_event_timestamp_s',''),
		UiEventSource=column_ifexists('ui_event_source_s',''),
		UiEventSequenceNum=column_ifexists('ui_event_sequence_num_s',''),
		UiEventId=column_ifexists('ui_event_id_s',''),
		TlsProtocol=column_ifexists('tls_protocol_s',''),
		TimestampDerived=column_ifexists('timestamp_derived_t',''),
		TargetUiElement=column_ifexists('target_ui_element_s',''),
		Sort=column_ifexists('sort_s',''),
		SessionType=column_ifexists('session_type_s',''),
		SessionLevel=column_ifexists('session_level_s',''),
		SessionKey=column_ifexists('session_key_s',''),
		SearchQuery=column_ifexists('search_query_s',''),
		SdkVersion=column_ifexists('sdk_version_s',''),
		SdkAppVersion=column_ifexists('sdk_app_version_s',''),
		SdkAppType=column_ifexists('sdk_app_type_s',''),
		RunTime=column_ifexists('run_time_s',''),
		RowsProcessed=column_ifexists('rows_processed_s',''),
		RowCount=column_ifexists('row_count_s',''),
		ResolutionType=column_ifexists('resolution_type_s',''),
		RequestStatus=column_ifexists('request_status_s',''),
		RequestId=column_ifexists('request_id_s',''),
		ReportIdDerived=column_ifexists('report_id_derived_s',''),
		ReportId=column_ifexists('report_id_s',''),
		RenderingType=column_ifexists('rendering_type_s',''),
		RelatedList=column_ifexists('related_list_s',''),
		RecordType=column_ifexists('record_type_s',''),
		RecordId=column_ifexists('record_id_s',''),
		Quiddity=column_ifexists('quiddity_s',''),
		QueryId=column_ifexists('query_id_s',''),
		PrevpageUrl=column_ifexists('prevpage_url_s',''),
		PrevpageEntityType=column_ifexists('prevpage_entity_type_s',''),
		PrevpageEntityId=column_ifexists('prevpage_entity_id_s',''),
		PrevpageContext=column_ifexists('prevpage_context_s',''),
		PrevpageAppName=column_ifexists('prevpage_app_name_s',''),
		PrefixesSearched=column_ifexists('prefixes_searched_s',''),
		ParentUiElement=column_ifexists('parent_ui_element_s',''),
		PageUrl=column_ifexists('page_url_s',''),
		PageStartTime=column_ifexists('page_start_time_s',''),
		PageEntityType=column_ifexists('page_entity_type_s',''),
		PageEntityId=column_ifexists('page_entity_id_s',''),
		PageContext=column_ifexists('page_context_s',''),
		PageAppName=column_ifexists('page_app_name_s',''),
		Origin=column_ifexists('origin_s',''),
		OrganizationId=column_ifexists('organization_id_s',''),
		NumResults=column_ifexists('num_results_s',''),
		NumberSoqlQueries=column_ifexists('number_soql_queries_s',''),
		NumberFields=column_ifexists('number_fields_s',''),
		NumberExceptionFilters=column_ifexists('number_exception_filters_s',''),
		NumberColumns=column_ifexists('number_columns_s',''),
		NumberBuckets=column_ifexists('number_buckets_s',''),
		MethodName=column_ifexists('method_name_s',''),
		Method=column_ifexists('method_s',''),
		MediaType=column_ifexists('media_type_s',''),
		LoginStatus=column_ifexists('login_status_s',''),
		LoginKey=column_ifexists('login_key_s',''),
		HttpMethod=column_ifexists('http_method_s',''),
		GrandparentUiElement=column_ifexists('grandparent_ui_element_s',''),
		EntryPoint=column_ifexists('entry_point_s',''),
		EntityName=column_ifexists('entity_name_s',''),
		Entity=column_ifexists('entity_s',''),
		EffectivePageTime=column_ifexists('effective_page_time_s',''),
		Duration=column_ifexists('duration_s',''),
		DisplayType=column_ifexists('display_type_s',''),
		DeviceSessionId=column_ifexists('device_session_id_s',''),
		DevicePlatform=column_ifexists('device_platform_s',''),
		DbTotalTime=column_ifexists('db_total_time_s',''),
		DbCpuTime=column_ifexists('db_cpu_time_s',''),
		DbBlocks=column_ifexists('db_blocks_s',''),
		CpuTime=column_ifexists('cpu_time_s',''),
		ConnectionType=column_ifexists('connection_type_s',''),
		ComponentName=column_ifexists('component_name_s',''),
		ClientVersion=column_ifexists('client_version_s',''),
		ClientId=column_ifexists('client_id_s',''),
		CipherSuite=column_ifexists('cipher_suite_s',''),
		CalloutTime=column_ifexists('callout_time_s',''),
		BrowserVersion=column_ifexists('browser_version_s',''),
		BrowserName=column_ifexists('browser_name_s',''),
		AverageRowSize=column_ifexists('average_row_size_s',''),
		AppType=column_ifexists('app_type_s',''),
		AppName=column_ifexists('app_name_s',''),
		ApiVersion=column_ifexists('api_version_s',''),
		ApiType=column_ifexists('api_type_s',''),
        ArticleVersionId=column_ifexists('article_version_id_s',''),
		ArticleVersion=column_ifexists('article_version_s',''),
		ArticleStatus=column_ifexists('article_status_s',''),
		ArticleId=column_ifexists('article_id_s',''),
        AnalyticsMode=column_ifexists('analytics_mode_s',''),
        BatchId=column_ifexists('batch_id_s',''),
        ClickedRecordId=column_ifexists('clicked_record_id_s',''),
		ClassName=column_ifexists('class_name_s',''),
        ComponentIdDerived=column_ifexists('component_id_derived_s',''),
		ComponentId=column_ifexists('component_id_s',''),
        ControllerType=column_ifexists('controller_type_s',''),
		Context=column_ifexists('context_s',''),
		ConsoleIdDerived=column_ifexists('console_id_derived_s',''),
		ConsoleId=column_ifexists('console_id_s',''),    
        ClientInfo=column_ifexists('client_info_s',''),
        DstBytes=column_ifexists('request_size_s',''),
		DstUser=column_ifexists('delegated_user_name_s',''),
        DstUserSid=column_ifexists('delegated_user_id_s',''),
		DstUserSidDerived=column_ifexists('delegated_user_id_derived_s',''),
        Data=column_ifexists('data_s',''),
		DashboardType=column_ifexists('dashboard_type_s',''),
		DashboardIdDerived=column_ifexists('dashboard_id_derived_s',''),
		DashboardId=column_ifexists('dashboard_id_s',''),
		DashboardComponentId=column_ifexists('dashboard_component_id_s',''),
		DvcAction=column_ifexists('action_s',''),
		DvcOS=column_ifexists('platform_type_s',''),
		DvcOSName=column_ifexists('os_name_s',''),
		DvcOSVersion=column_ifexists('os_version_s',''),
        DeliveryLocation=column_ifexists('delivery_location_s',''),
		DeliveryId=column_ifexists('delivery_id_s',''),
        DocumentIdDerived=column_ifexists('document_id_derived_s',''),
		DocumentId=column_ifexists('document_id_s',''),
        EntityType=column_ifexists('entity_type_s',''),
        EntityId=column_ifexists('entity_id_s',''),
        FileType=column_ifexists('file_type_s',''),
		FilePreviewType=column_ifexists('file_preview_type_s',''),
		ExceptionType=column_ifexists('exception_type_s',''),
		ExceptionMessage=column_ifexists('exception_message_s',''),
		Ept=column_ifexists('ept_s',''),
        EventCount=column_ifexists('number_of_records_s',''),
		EventEndTime=column_ifexists('timestamp_s',''),
		EventResult=column_ifexists('status_code_s',''),
		FileSize=column_ifexists('size_bytes_s',''),
        HttpReferrerOriginal=column_ifexists('referrer_uri_s',''),
		HttpUserAgentOriginal=column_ifexists('user_agent_s',''),
		HttpUserAgent=column_ifexists('browser_type_s',''),
        LogGroupId=column_ifexists('log_group_id_s',''),
		LimitUsagePercent=column_ifexists('limit_usage_percent_s',''),
		LicenseContext=column_ifexists('license_context_s',''),
		LastVersion=column_ifexists('last_version_s',''),
		Language=column_ifexists('language_s',''),
		JobId=column_ifexists('job_id_s',''),
		IsSuccess=column_ifexists('is_success_s',''),
		IsSecure=column_ifexists('is_secure_s',''),
		IsScheduled=column_ifexists('is_scheduled_s',''),
		IsNew=column_ifexists('is_new_s',''),
		IsMobile=column_ifexists('is_mobile_s',''),
		IsLongRunningRequest=column_ifexists('is_long_running_request_s',''),
		IsGuest=column_ifexists('is_guest_s',''),
		IsFirstRequest=column_ifexists('is_first_request_s',''),
		IsError=column_ifexists('is_error_s',''),
		IsApi=column_ifexists('is_api_s',''),
		IsAjaxRequest=column_ifexists('is_ajax_request_s',''),
        ManagedPackageNamespace=column_ifexists('managed_package_namespace_s',''),
        HttpHeaders=column_ifexists('http_headers_s',''),
		NetworkDuration=column_ifexists('time_s',''),
        Name=column_ifexists('name_s',''),
        NumberFailures=column_ifexists('number_failures_s',''),
        NumClicks=column_ifexists('num_clicks_s',''),
        OperationType=column_ifexists('operation_type_s',''),
		NumSessions=column_ifexists('num_sessions_s',''),
        PageName=column_ifexists('page_name_s',''),
        Query=column_ifexists('query_s',''),
        RequestType=column_ifexists('request_type_s',''),
        ReportDescription=column_ifexists('report_description_s',''),
		ReopenCount=column_ifexists('reopen_count_s',''),
        RelatedEntityId=column_ifexists('related_entity_id_s',''),
        RecordIdDerived=column_ifexists('record_id_derived_s',''),
        ReadTime=column_ifexists('read_time_s',''),
		Rank=column_ifexists('rank_s',''),
		SrcBytes=column_ifexists('response_size_s',''),
		SrcDvcId=column_ifexists('device_id_s',''),
		SrcDvcModelName=column_ifexists('device_model_s',''),
		SrcIpAddr=column_ifexists('source_ip_s',''),
		SrcNatIpAddr=column_ifexists('client_ip_s',''),
        SessionId=column_ifexists('session_id_s',''),
        SiteId=column_ifexists('site_id_s',''),
		SharingPermission=column_ifexists('sharing_permission_s',''),
		SharingOperation=column_ifexists('sharing_operation_s',''),
		SharedWithEntityId=column_ifexists('shared_with_entity_id_s',''),
		UrlOriginal=column_ifexists('url_s',''),
		WaveTimestamp=column_ifexists('wave_timestamp_s',''),
		WaveSessionId=column_ifexists('wave_session_id_g',''),
		ViewStateSize=column_ifexists('view_state_size_s',''),
		VersionIdDerived=column_ifexists('version_id_derived_s',''),
		VersionId=column_ifexists('version_id_s',''),
        TriggerType=column_ifexists('trigger_type_s',''),
		TriggerName=column_ifexists('trigger_name_s',''),
		TriggerId=column_ifexists('trigger_id_s',''),
		TransactionType=column_ifexists('transaction_type_s',''),
		TotalTime=column_ifexists('total_time_s',''),
        TabId=column_ifexists('tab_id_s',''),
		StackTrace=column_ifexists('stack_trace_s','')
| project-away  *_s